11111111111111
10100000000001
10102201111111
10102200000001
10100000000301
10104000000301
10104000000301
10004000000301
10111111111101
10000000000001
10111111111111