S
002000000000000000000000000000
663222222222222222222222222222
630020000000000020000000003331
630000000000000020600003333001
630020000000000020366633000001
660225555550500030003330000001
060000000000500000366000000001
060030044450566230600000000001
060006664040500000000000000001
060430064050500200000000000001
060400064000500255555000006001
060430064050500200000000060001
060006664050506211111106660001
060030060000500200000066000001
060000000050500200000660000001
066666660000500200066600000001
066000060050500200022000000001
066066060650500200002200000001
060006060000000200000200000001
060006055550500200000220000001
060006000000500200000022000001
060006055550500200000002000001
060006000000000200000002200001
060006000000000200000000220001
06000600V000000200000000022001
060006000000000200000000002001
060006000000000200000000002201
060006000000000200000000000221
060006000000000200000000000021
111111111111111111111111111111