S
1111111111111111111111111111111111111
0001120000000000000000000000000000001
1001120000000000000000000000000000001
1001110000000000000044400000000000001
1001110000000000000044400000000000001
2002222220000000000000000000000000001
2000000024440000000000000000000000001
2222220033330000000000000000000000001
3000000030000000002220000000000000001
3300000030000000002220000000000000001
3330000030000000002220000001110000001
3330000030000000000000000001110000001
3330333330000000000000000000000000001
1000000333300000000000000000000000001
1000000333300000000000000000000000001
1000000100000000000000000000000000001
1000000100000000000000000000000000001
1000000100001110000000000000000000001
1000000100000000000000000000000000001
1004444111111111000000000000V00000001
1001000000000001400000000000000000001
1001020000000001400000000000000000001
1001014444444444400000000000000000001
1000000000000000000000000000000000011
1111111111111111111111111111111111111